фун: выни фун карде высморкать нос, сморкаться
дəгеш (дəгиш, дәjиш):дəгеш бе меняться, изменяться, заменяться; дəгеш карде менять, изменять, заменять; обменивать; обмениваться; әј һәреф-ыш дəгеш карде он заменил букву; әмə дəгеш-ымон карде мы обменялись кольцами
ден-ден (дем-дем): денден карде громко ворчать, браниться
кекәв (кекәф): кекәвә до клен
ајилмиш: аилмиш бе очнуться, прийти в себя; аилмиш бим, банем, һич кәси ни я пришел в себя, глядь, никого нет
бози: бози оме сбивать с толку, морочить голову; подшучивать; обманывать; əв бә ты бози омедə он морочит тебе голову 
амбыр: амбырə до железное дерево, демир-агач
виəнды: виәнды карде а) закрывать (жмурить) глаза; чәши винды быкә, кинә нуон бедə закрой глаза, дочка спрячется; б) зажимать; сжимать (пальцы в кулак)) даси ви быкә сожми [пальцы] в кулак; в) закрывать (напр. собрание, заседание и п.); сəдри иҹлос-ыш винде карде председатель закрыл собрание
выло: выло бе а) разливаться; ов воло бе вода разлилась; б) рассеиваться, распыляться; в) разрушаться; пропадать; чәмə дəвлəт бо выло ныбејо, кинə бә зуә бәдəмон фольк. чтобы не пропало	наше богатство, отдадим дочь за этого парня; г) разоряться; воло карде а) разливать; б) рассеивать, распылять; в) разрушать; г) разорять; немек һырие әмəн-ыш воло карде, быкаштəмон фольк. покупать соль разорительно для нас, давайте-ка посеем ее 
ханачу: ханачу чәлə ткацкий станок
һәх: һәх бе остолбенеть, замереть 
ча: ча дое а) крутить, вертеть; мешать, размешивать; де кечә ду ча дојдә она размешивает ложкой сыворотку; б) молотить; xəмəни ча дое молотить на току с помощью быков; xəмəни ча дə! погоняй быков на току, молоти!; в) пасти; чәш ча дое ооводить глазами; əв бә һa тəрəфи-ш ча дој on обвел глазами вокруг; ча карде пастись; мол ча кардə скот пасется
kıtə: кытə бе собираться
poşkə: пошкә карде чистить, очищать
гечикмиш: гечикмиш бе опаздывать; мы гечикмиш бәбем бә дарси я опоздаю на урок
авдал: авдал бе расстраиваться, падать духом; дарди ве-ку авдал бә он совсем пал духом от горя
гелләш: гелләшә до тюльпанное дерево
гəвәвенҹә: гəвәвенҹә карде зевать; әғыли һан-ыш һесе, гəвенҹә кардə ребенок хочет спать, зевает
сынов: сынов карде (же) плавать
та: та карде надевать; одевать; носить (платье); ыштəни та карде одеваться 
тахир:	 тахир карде медлить, задерживаться; опаздывать; әгәм тахир быком, əв бәше если я задержусь, он уедет; бә тахир еганде замедлять, задерживать
чә-чә: чә-чә же петь (о птицах); щебетать, чирикать; щелкать (о соловье); былбыл бәркәдə чә-чә жәјдә громко щелкает соловей; кумә кижə чәһ-чәһ жедə воробей чирикает 
ва: ва дое (ное) а) пускать, отпускать, выпускать; освобождать; мы ни ва быдə отпусти меня; мелы авшумə тоғ ва дојдә шелковичный червь выпускает нить; б) покидать, оставлять; вејә одәмон ыштә жен, һырдәнон ыштә вәтәнәдә ва доә бин, шедә бин многие оставляли на родине своих жен и детей и уходили
ва: ва карде звать, призывать; әј ва кардə бә кә его зовут домой
ҹәлв: ҹәлв карде привлекать 
дарыхмиш: дарахмиш бе скучать, печалиться, тосковать, горевать; һеч дарахмиш мəби, һәммә чок бәбе не надо горевать, все будет хорошо 
нојил: нојил бе достигать, добиваться; охо бә штə мәғсәди нојил бим наконец, я достиг своей цели
нубәјнә:	нубәјнә карде пробовать свежие фрукты или овощи первый раз в сезоне
охшəш: охшəш дое походить, быть похожим; əв бә штə нəнə охшəш дојдә он похож на свою мать
очәјә: очәјә кинə падчерица
пошкә: пошкә карде чистить, очищать 
сахланмиш:	 сахланмиш карде беречь, хранить, сохранять, охранять
орыкнə: орыкнə оме сердиться, рассердиться, разгневаться; нəнə-ш ве орыкнə омәј, əв-ыш куә его мать очень рассердилась и побила его
ноз:	ноз карде а) ласкать; бә һырдәни нозə быкәм я хочу приласкать ребенка; б) кокетничать; капризничать, жеманиться; кинəли, кинəли, ты нозə мәкә фольк. девушка, девушка, ты не кокетничай! 
нызон: бы нызони а) недавно; б) скоро; бы нызон шедəм я скоро уезжаю
дијәнон: дијәнон екарде морщиться, хмуриться, делать недовольное лицо; дијәнәвон-ыш ека он нахмурился 
евашт-певашт: евашт-певашт карде а) подпрыгивать; б) перен. приходить в волнение, волноваться, нервничать; бо һap сыханијо евашт-певашт кардедəн они волнуются из-за каждого слова; в) бороться, драться
кытə: кытə бе собираться; кытə карде собирать
кучмиш:	кучмиш бе переселяться; һa кәси һамусуа бевәҹ-е, кочмиш быбу погов. каждый, у кого плохой сосед, пусть переселится
мəф: мəф бе гибнуть; мəф карде губить, уничтожать
моəг: моəгә кағ курица-несушка 
мојдон: мојдонә асп кобыла
мот: мот бе (манде) удивляться, поражаться, изумляться; недоумевать 
мырəxəс: мырəxəс бе а) освобождаться; б) разрешаться от бремени (о роженице); мырəxəс карде освобождать, отпускать
марағлəнмиш: 	марағләнмиш бе интересоваться, быть заинтересованным
дыволи: дыволи әғыл уст. ребенок, которого лечат от испуга молитвой
гин: гин бе пропадать, исчезать; теряться; сгинуть разг.; чымы тилə гин бә у меня пропал нож; гин [бы]би! сгинь!, отстань!; гин карде терять; ыштə ро-мон гин карде мы потеряли дорогу; ыштə[ни] гин карде растеряться, прийти в замешательство; ше гин бә кәси имон гин-е посл. у кого пропала вещь, у того и вера пропала
гыло: чәши гыло зрачок
гулу (гули): гулу бе а) сваливаться, скатываться; проваливаться; чы бандəдə сығ гулу бе с горы скатился камень; б) перен. терпеть неудачу; отступать; əв руж бә руж гулу бедə он постоянно терпит неудачи; гулу бә гулу бе скатываться; бә чолə гулу бе он свалился в яму; гулу карде сбрасывать, сваливать, скатывать, скидывать; кисон чы әрəбоно гулу кардə бин они сбросили мешки с арб
баштәмиш:	 баштәмиш карде начинать; приступать
азмиш: азмиш бе а) заблудиться; заплутаться; əв вишəдə азмиш бә он заблудился в лесу; б) перен. заблуждаться, ошибаться 
алышмиш: алышмиш бе привыкать
аллатмиш: аллатмиш карде обманывать
арə: арə бе нравиться; одобрять, быть довольным; һамсуә жен ве рыкин-е, де шәтәләтиш-ән арə ныбе соседка очень рассердилась, она была недовольна его озорством 
артмиш: артмиш бе увеличиваться, прибавляться; артмиш карде увеличивать, прибавлять
ашығ: ашығ бе влюбляться, полюбить; ə зуə ашығ бе б-әј тот парень влюбился в нее
бағыштәмиш:	бағыштәмиш карде а) дарить; б) прощать, извинять; мыни бағыштәмиш быкә прости меня
бандәғ: бандәғ гыние застревать; зацепляться 
баҹармиш: баҹармиш карде уметь, быть в силах, справляться; баҹармиш-ыш ка, обәғәтемон, баҹармиш-ыш ныкаше, бебәкамон [если он] справится [с делом], оставим его, не справится, прогоним
баштәмиш:	 баштәмиш карде начинать; приступать
бәзəмиш: бәзəмиш карде наряжать, украшать
бәму: бәму карде зарывать, закапывать; погребать, хоронить
бәрбод: бәрбод карде разрушать, разорять; пускать на ветер
бәрдошт: бәрдошт бе богатеть; əвон бәрк бәрдошт бән они сильно разбогатели; бәрдошт карде а) обогащать; б) создавать, творить
бәсəпо:	 бәсəпо әјште встать на ноги; бәсəпо манде (бе) стоять на ногах 
бәһәшə: бәһәшə же отказываться, отнекиваться, отпираться, не признаваться; бәһәшә бәжем, бәвытем ки һич бәмедə ныбим стану отпираться, скажу, что я совсем не плакала 
биздəмиш:	 биздəмиш карде стрекать, колоть, погонять стрекалом 
бынəкор: поло бынəкор корочка плова (на дне котла)
бози : бози оме сбивать с толку, морочить голову; подшучивать; обманывать; əв бә ты бози омедə он морочит тебе голову 
бур: бур же мычать
буррə: буррə дое выть; во буррə додә бе завывал ветер
вағе: вағе бе а) происходить, случаться; б) находиться, быть расположенным, располагаться
варз: варз дое месить (обычно тесто); һәми варз дојдәм я мешу тесто
ват: ват карде свежевать, сдирать шкуру
вән : вәнə до бук; ясень вәнəшə фиалка 
вәрәвурд: вәрәвурд карде а) выбирать, подбирать, приглядывать; мизи нојо вырə вәрәвурд-ым кај я выбрал место, где [можно] поставить стол; б) раскладывать, размещать, расставлять по местам
вәш: вәш гәте загораться, гореть
выр-выр:	 выр-выр	карде ругаться; браниться; ворчать
гаккә: гаккә же кудахтать; каг гаккә жедə курица кудахчет
гәв-гуш: гәв-гуш моле вытирать рот (после еды)
гулу-гулу (олугулу): гулу-гулу карде метаться; крутиться с боку на бок; гулу-гулу һарде перекатываться с боку на бок 
гәле-гәле: гәле-гәле поје ходить, раскорячив ноги гәлə 1) отара; стадо [коз); пəси гәлə овечья отара 2) редк. стадо [керов); молə гәлə стадо коров
гəп: гәп же говорить, болтать; рассказывать; чичи-ку гәп жедəш? о чем ты говоришь?; əв һежо гәп әжәниј он много болтал; əв-əн ыштə ғәзијә гәп жәјдә он рассказывает о своем приключении
гәрəк: гәрəк бе быть нужным (необходимым), понадобиться
гәшт:	гәшт карде гулять; обходить; ходить взад и вперед, прохаживаться
гырдə: гырдə бе а) собираться; гырдə бин һәмә ди әһл фольк. собрались все жители селения; б) окружать; обступать; омәјн, гырдə бин бә чәј сə люди подошли, обступили его; гырдə карде а) собирать; подбирать; б) убирать, прибирать; чы мәктәби утоғи гырдə кардедə он убирает класс <> дас-по гырдə карде взять в руки; образумить; чәј дас-по чок-чоки гырдə бәкардем я возьму его в руки гырдəбе:	гырдəбе ныште сидеть, скрестив ноги, сидеть по-турецки; əвон гырдəбе ныштəн они сели по-турецки
ғајдә-ғанун:	ғајдә-ғанун омуте поучать, читить нотацию; чок, чок, бә мы ғајдә-ғанун омәмут хорошо, хорошо, не учи меня
ғәрғ:	ғәрғ бе тонуть; захлебываться
ғынбәчырт:	ғынбәчырт ныште вульг. сидеть на корточках
ғыр : ғыр бе погибать, гибнуть; əвон һәмә ғыр бин даве вахтəдə они все погибли во время войны; ғыр карде губить, уничтожать 
дамə:	дамə бе заговаривать, вступать в разговор; дамə быби-əни! да заговори же!; дамə карде заговаривать, обращаться к кому 
дəвом: дəвом бе длиться, продолжаться; дəвом карде (барде) продолжать; мәктәби дарсон дəвом кардедə бе он продолжил уроки в школе; дəвом варде терпеть, переносить, выносить; выстоять, устоять; дəвом һарде продолжать; продолжаться
дəли-дивонə:	дəли-дивонə бе обезуметь, сойти с ума
дəнг: дәнг бе быть замороченным, обалдеть; дəнг карде морочить голову 
дəнəм-пенəм:	 дəнəм-пенəм карде сгибаться и разгибаться (о человеке)
дəрты-выло: дəрты-выло бе разоряться; разрушаться; дəрты-выло карде разорять; разрушать
дил: һачари дил ключ от висячего замка 
дыборə: дыборə алəф отава
дылванди: дылванди дое утешать
дыпан: дыпан бе съеживаться, сжиматься, ежиться; ысəт мыни виндејәдәј, дыпан бедə теперь, видя меня, он съеживается [от страха]
дычо: дычо бе а) встречаться, сталкиваться, наталкиваться; дычо бин бә гләј јолә руј фольк. попалась им какая-то большая река; б) подвергаться; попадать (в какое-л. положение); оказаться, очутиться; чәј гәдəлијә шогырд бә гыләј дард дычо бе ее маленький ученик попал в беду; дычо карде подвергать 
дохил: дохил бе входить; бә утоғ дохил бе входить в комнату
думот: думот карде (ше) задумываться, думать; бочи думот шедəш? <> чем ты задумался?
евлəнмиш: евлəнмиш бе вступать в брак; жениться; пожениться; əвон евлəнмиш бән они поженились; евлəнмиш карде заключить брак 
екыр:	тамə екыр карде чувствовать аппетит, хотеть есть
епəре: епəре-пепəре порхать (о птицах)
ерəск: ерəси карде хватать, быть достаточным; чәмə əвеч ерəси кардедəни нам не хватает инструмента
етыно: етыно карде обращать внимание, замечать; б-әj етыно ныкај он не обратил на него внимания 
әлəшмиш: әләшмиш бе трудиться
әһотә: әһотә карде окружать; обступать; әмəн-ышон әһотә карде нас окружили
живыш:	живыш карде редк. жить, проживать; канə кумаонәдә живыш-ымон карде мы жили в старых домах
заве-заве: заве-заве карде ползать (о человеке); һырдән заве-заве кардедə ребенок ползает
зандымон: зандымон карде рожать 
зардинə:	моғнә зардинə яичный желток
зəнд: зəнд карде полагать, считать; думать; догадываться; жого занд-ым карде ки мыни зынедəн я считал, что они меня знают
зид: зид бе противиться, быть против
зир-зəбәр: зир-зəбәр карде уничтожать, разрушать
зу-бәло: де зу-бәло с большим трудом, выбиваясь из сил
изо-ҹәзо: изо-ҹәзо карде (дое) издеваться, насмехаться, высмеивать; б-әј изо-ҹәзо мәкән, бә гәдəлијон изо-ҹәзо дој нибәбе не насмехайтесь над ним, нельзя издеваться над маленькими
ијрәнмиш: ијрәнмиш бе брезгать
иктыфо:	иктыфо карде довольствоваться, удовлетворяться
инҹимиш: инҹимиш бе а) мучиться, страдать; бынышт, инҹимиш бәш посиди, ты измучился; һого инҹимиш бедəм, чымы зу-м-əн ни я очень мучаюсь, у меня нет никаких сил; б) обижаться; чымы-ку инҹимиш мəой не обижайся на меня; инҹимиш карде а) мучить; һырдәни инҹимиш мəкә не мучай ребенка; б) обижать
јашәмиш: јашәмиш бе жить, проживать; əв Ликәдə јашәмиш бедə он живет в Лерике
јијә: јијә пулә рисовая шелуха (после второго обмолота)
кечмиш: кечмиш бе прощать, извинять 
кәнг:	 кәнг бе одуреть
кәнул: кәнул карде подрезать (фруктовые деревья) 
кәшбәку: кәшбәку карде связать крылья птице; кәшбәку быкә, быдə ныпəро свяжи крылья птице, чтобы не улетела
кәшпəр: кәшпəр кује а) метаться (о больном); б) биться (о птице)
кифојәтләнмиш: кифојәтлəнмиш бе довольствоваться
кок : кокә чај кирпичный чай
коп:	коп-копы прятки, игра в прятки; коп-е, һозо-је? готово, спрятались?
ку-кәләг: ку-кәләг дәғанде галдеть, шуметь (о толпе)
куф: куф һарде качаться, раскачиваться
кучмиш (кочмиш):	кучмиш бе переселяться; һa кәси һамусуа бевәҹ-е, кочмиш быбу погов. каждый, у кого плохой сосед, пусть переселится
лај-лај: лај-лај же баюкать (ребенка) 
ләғ-ләғә: ләғ-ләғә карде насмешничать, издеваться 
лəф: лəф же хвастать 
лəчә: лəчә карде лизать 
лој-лоj:	 лој-лој һарде (карде) идти вперевалку, переваливаться; били һышкәдә лој-лој карде-карде де зуј пыједә утка посуху идет с трудом, переваливаясь с боку на бок
мәғ : кәлəми мәғ кочерыжка; куни мәғ анат. копчик
мəтол: мəтолə до тал, тальник
мәһәл: мәһәл ное обращать внимание, замечать; əв һич бә женон мəһəл нодəни он не обращает внимания на женщин
мəчә: мəчә до липа 
мијонәзу: мијонәзу гәте бороться один на один, бороться врукопашную; сыпə зуә, мијонәзу быгәт фольк. собачий сын, поборись один на один [со мной]
мио-мио: мио-мио карде мяукать
мығәт: мығәт бе беречь, хранить; һa кәлхозчи бәпе машинон-ку мығәт быбу каждый колхозник должен беречь машины; ыштə-ку (ыштəни) мығәт быби! береги себя!
мыз-мыз: мыз-мыз карде 1) ворчать; бурчать 2) скрипеть
мыр-мыр: мыр-мыр карде а) ворчать, бормотать; б) тихо рычать (о собаке); в) мурлыкать (о кошке)
мыртə: мыртə карде ворчать, бормотать 
мысəллəт: мысəллəт карде насылать, навлекать (беду, неприятность и я.) <> хыдо бә мын-ыш гләј дард-ыш мысəллəт карде фольк. бог послал мне горе; бә чәј андоми гыләј ҹын мысəллəт быкәм фольк. я нашлю на него джинна
мовард: мовардо, мовардəдə от рождения, с рождения; əв шəтəгыр-е мовардо он хром от рождения 
молол: мололә до ольха 
нави: нави гәте предупреждать, предотвращать 
нил : нилә до дзельква граболистная, дзельква гирканская (дерево)
ноғо:	ноғо карде (дое) стеречь, оберегать, охранять; сыпә дəрыведə, ноғо дојдә собака лает, стережет [дом]
ноһо: ноһо бе прятаться, скрываться; ноһо карде прятать, скрывать
обурә: обурә оме огорчаться, расстраиваться; һәни бо сыхан кардејо-н ғыдрəт-ыш ныбе, обурә омәј дəманде бәме у него уже не было сил говорить, он расстроился и заплакал
ованг: ованг оме кричать; реветь; нырс ованг омə медведь заревел
овәррə: овәррə оме кричать, орать, вопить
огырд: огырд варде окружать; обступать; фәһлон чы һap тоно буруғ-ышон огырд вардə бе рабочие со всех сторон окружили скважину
оғәт: тəлxə оғәт плохое настроение; чымы оғәт тəлх-е, аз парт-ым у меня плохое настроение, я расстроен
озиккә: озиккә оме кричать, орать; чымы аму сəпе озиккә омәј он кричал на моего дядю
око : око дое а) поворачивать, заворачивать (на ходу, налету); б) отталкивать; мыни бәрк око доше, тарсәјм он резко оттолкнул меня, и я испугалась; в) пахать (на волах, на быках); погонять (волов, быков); управлять (машиной); дəдə кәлон око додə отец пашет на быках
оларз: оларз оме вздрагивать; бердəм гуррә еманде, һәмә оларз омәј вдруг раздалось рычание, все вздрогнули
оныррə: оныррə оме зарычать, зареветь
орош-дорош:	орош-дорош дое украшать, наряжать
осəдо:	осəдо оме говорить; звучать
отымб: отымб оме грозить, угрожать; пугать; бә зуоно отымб омəј он напугал мальчиков
отов: отов оме грозить; выговаривать
оһан: оһан манде спать; оһан ше ,спать, засыпать; чы пичи палу-ку оһан ше он заснул возле печи 
оҹыррə:	 оҹыррə	варде скрипеть; ды штə ручкә оҹыррə вардедə он скрипит пером
ошкорə: бә ошкорə явно, открыто; ошкорə карде обнародовать, разглашать; аз бә ты ашыг-ым ошкорə-ш мекә фольк. я влюблен в тебя, ты этого не разглашай
париз: париз карде воздерживаться, остерегаться; избегать; чырки-ку кардəм париз я стараюсь не запачкаться
певыло:	певыло бе а) распространяться, рассеиваться; рассыпаться; разливаться; һәши рушнә бә һap врә певыло бә солнце залило все вокруг; б) разоряться; певыло карде а) распространять; рассыпать; разливать; бырз-ым певыло-м кај я рассыпал рис; б) разорять
пешон: пешон карде провеивать
пештə: бә пештə сложный послелог после; ыми бә пештə после этого; образует деепричастные обороты, обозначающие действие, совершаемое ранее другого г действия; техникә мəктəб орохнə бә пештə, дəбәшем бә институт окончив техническое училище, я поступлю в институт
пəлешк: пəлешк бе вянуть, увядать, сохнуть (о растениях)
пəшил: пəшил бе вянуть, увядать; выл пəшил бе цветок увял
пинәки: пинә ки же клевать нбсом, дремать
пылопат: пылопатә кә кухня
пытыпоə: пытыпоә карде разрывать на куски, рвать на части; шири əв-ыш бә саһати пытыпоə карде лев сразу же разорвал его на куски
по : бә... по ное складывать одно к одному;складывать вместе похожие предметы; китоби бә китоби по, дəфтəри бә дəфтəри по бынə сложи книги с книгами, а тетради с тетрадями; пəси бә пəси по, бызи бә бызи посл. овца с овцой, коза с козой (соотв. яблоко от яблони недалеко падает)
позмиш:	 позмиш 	карде а)	портить, расстраивать; б)	зачеркивать, вычеркивать; чымы ном позмиш быкә зачеркни моюфамилию
појмол:	појмол бе портиться, пропадать, гибнуть; ангы амбу-ән појмол бе виноград и груши испортились; појмол карде губить, портить, изводить; ты ыштə пул-ы појмол кардə ты зря извел свои деньги 
покәму:	покәму бе линять (о животных, птицах) 
пуршə: нунə пуршə крошки хлеба
рајыш: рајыш бе соглашаться
рəд: рəд бе отодвигаться в сторону; отклоняться; рəд карде отклонять; отодвигать; ыштə чәши рəд ныкардәј бә лампə он не отводил глаз от лампы 
рəзо: рəзоə до ольха
рəһмəт: хыдо рəһмəт быкә царство [ему] небесное (о покойном; букв. да помилует бог); рəһмəт ше скончаться; рəһмəт шə пыə-ш бәјжи бејәдә... когда был жив его покойный отец...
сајырбајыр:	 сајырбајыр карде бредить 
сардон: сардон бе остывать, охлаждаться; ысəт-əн ым шорбә сардон бәнине теперь суп остынет
сачылмиш: сачылмиш бе светить[ся1, освещать; нəши сачылмиш бе светило солнце
сесысу: сесысу карде пробовать, посолена ли пища 
сәј : сәј карде а) стараться; заниматься; бә шты дарси сәј быкә займись своими уроками; б) заботиться
сə-чон: де сə-чони с увлечением, увлеченно, с əнтузиазмом
синкә: синкә ордə мука-первач
сипарə: сипарə ное рел. читать коран после похорон
сироб: сироб бе насыщаться, получать что-л. вдоволь; наполняться; зəмин ды ови сироб бе земля пропиталась водой; сироб карде дать чего-л. вдоволь; насытить
сит: сит карде перебарщивать прост.; хватить через край
та : та карде обижаться; сердиться 
тадибәсə:	тадибәсə бе торопиться; əв һеч тадибәсə бедəни он никогда не торопится
таныш: таныш бе знакомиться; таныш карде знакомить; ыштəни таныш карде представляться, называть себя
таныштырмиш:	 таныштырмиш карде оглашать, оповещать
тарсмиш: тарсмиш карде пугать, страшить
тәк-тук: тәк-тук карде трещать, издавать треск 
тəлəсдирмиш:	тəлəсдирмиш карде торопить
тəлəсмиш:	тəлəсмиш бе торопиться, спешить
тəп:	тəп-тəмиз чистый
тəраш: тəраш карде подрезать (плодовые деревья), производить подрезку 
тәсәввур: тәсәввур карде воображать, представлять себе
тəслим: тəслим карде а) выдавать; передавать; б) выдавать; предавать
тәһвил: тәһвил дое выдавать; передавать; сдавать 
тикмə: тикмə же вышивать; шить
тинг: тинг карде точить, оттачивать, заострять; мы ғәләми тинг кардəм я точу карандаш; гуш[он] тинг карде навострить уши (о животных)
тык-тык: тык-тык карде стучать, долбить; клевать
тыр-тыр: тыр-тыр карде тарахтеть, греметь, громыхать
то : то карде складывать, свертывать 
туш : туш оме а) встречаться, сталкиваться; бә гыләј гәми туш оме уми кардә бимон фольк. мы надеялись встретить какой-либо корабль; б) соответствовать; совпадать; әчәј кардə һәрәкәтон бә чәј кардә сыханон туш омедəн его слова соответствуют его делам
увәноә: увәноә каг курица-несушка
утанмиш: 	утанмиш бе стесняться, стыдиться; бој, бынышт, утанмиш мәби иди садись, не стесняйся
фырси-фырси:	фырси-фырси ше ползти; мор фырси-фырси шедə змея ползет
фырч:	фырч карде ш. давить, выдавливать, жать, выжимать; ангы фырч кардə он давит виноград фыстығ бук; фыстығә до бук, буковое дерево
фыш-фыш: фыш-фыш карде шипеть; гужд товәдə фыш-фыш кардə мясо шипит на сковороде 
фош: фош карде разоблачать
ханачу: ханачу чәлə ткацкий станок
хатырланмиш: хатырланмиш карде вспоминать, помнить
хеј: хеј карде аст., прятаться, хорониться 
xəш: xəш омəш! здравствуй!, добро пожаловать! (приветствие хозяина гостю); xəш омəш, бој, бынышт! здравствуй, входи, садись!; xəш омə[ш] дое здороваться; б-әј xəш омəш быдə! поздоровайся с ним!
хыјә:	 хыјә карде лер., мам. утихать, затихать; әгыли хыјә карде ребенок утих 
хыр : хыр карде раздражаться; вспылить 
хоштəмиш:	 хоштəмиш карде одобрять, выбирать, облюбовывать; нравиться; аз ым ранги хоштəмиш кардəм мне нравится этот цвет 
һамуш: һамуш бе гаснуть, тухнуть; ишиг һамуш бе свет погас
һәво : һәво дое разжигать ссору; подначивать прост.; əвон даве гәттəн, аз б-əвон һәво додəм они ссорятся, а я их подначиваю 
һәм: һәм... һәм[-ән]... и... и...; как..., так и ...; зуә һәм вәши гәтə, һəм-əн тəши фольк. юноша и есть захотел и пить
һәмәлотә:	һәмәлотә дое толкать, подталкивать; әј һәмоләтә-ш дој он подтолкнул его
һифз: һифз карде учить наизусть; кали толышə кәлимон-ыш һифз карде он выучил несколько талышских выражений
һишки: һишки дое натравливать, науськивать; сыпəни һишки мəдə не натравливай собаку [на людей] 
һылə: һылə же а) жалить; б) протыкать 
һырдəсə:	 һырдəсə	 мол мелкий скот
һоди: һоди карде беречь, оберегать; һоди кә, оғәт еныгыно оберегай [его], чтобы он не упал 
чап: чап бе печататься; чап карде печатать 
чатмə: чатмə бәв[он] сросшиеся брови 
чашмиш: чашмиш бе путаться, сбиваться с толку, теряться
чәғ: чәғә һырдән грудной ребенок
чәшмә : чәмә кә се чәшмә-је наш дом трехкомнатный; чывон кәј и чәшмә-ј бән их дом был однокомнатный
чимчәшмиш: чимчәшмиш бе брезгать, чувствовать отвращение
чонәј: чонәј карде передразнивать; əв чымы чонәј кардə он меня передразнивает; әчәј чонәј мəкә не передразнивай его 
чорт: бә чорт ше задуматься, углубиться в свой мысли; ты бә чорт шəш ты задумался
чоч: чочә торə зелень (приправа к еде)
ҹәллəг: ҹәлләғ карде прививать (растения)
ҹидды-ҹәһд: ҹидды-ҹәһд карде стараться изо всех сил 
ҹонкәныш:	ҹонкәныш карде умирать
чум: ҹум һарде нырять; окунаться; ҹујәдә ҹум баһам я буду нырять в реке 
шəст: де шəсти гордо, горделиво, с горделивой осанкой; де шəсти појдә он ходит гордо выпрямившись 
шијә : шијә кә глиняный дом; шијә карде обмазывать глиной (дом)
шијә : шијә пулә пылеобразные отходы риса после третьего обмолота; шијә карде растирать в порошок 
шыкырə: бә шыкырə на весу; бә шыкырə манде висеть, оставаться на весу; аз пебәшем бә до, бәгәтем чә холəдə, бә шыкырə бәмандем фольк. я влезу на дерево, ухвачусь за ветку и повисну
шынгəват: 	шынгəват карде свежевать; пəси шынгəват карде он освежевал овцу
шыртə: шыртə карде мас. давить, жать, выжимать 